111111111111111111
1C1000111100C00001
1010C001E011110011
1011010001000000O1
10000C1100010001C1
111111111111111111