1111111111111
1C110000C0001
1000011111001
1P0011E0000C1
1111111111111