11111111
111P1111
111000C1
11111101
1E000001
11111111