11111111
110P1111
110000C1
11111101
1E000001
11111111